##                                                                                                                                             ##
#################################################################################################################################################
##                                                                                                                                             ##
##                                                                                                                                             ##
##                                                                                                                                             ##
##                                                                                                                                             ##
##                                                                                                                                             ##
##                                                                                                                                             ##
##                                                                                                                                             ##
##                                                                                                                                             ##
##                                                                                                                                             ##
##                                                                                                                                             ##
##                                                                                                                                             ##
##                                                                                                                                             ##
##                                                                                                                                             ##
##                                                                                                                                             ##
##                                                                                                                                             ##
##                                                                                                                                             ##
##                                                                                                                                             ##
##                                                                                                                                             ##
##                                                                                                                                             ##
##                                                                                                                                             ##
##                                                                                                                                             ##
##                                                                                                                                             ##
##                                                                                                                                             ##
##                                                                                                                                             ##
##                                                                                                                                             ##
##                                                                                                                                             ##
##                                                                                                                                             ##
##                                                                                                                                             ##
##                                                                                                                                             ##
##                                                                                                                                             ##
##                                                                                                                                             ##
##                                                                                                                                             ##
##                                                                                                                                             ##
##                                                                                                                                             ##
##                                                                                                                                             ##
##                                                                                                                                             ##
##                                                                                                                                             ##
##                                                                                                                                             ##
#################################################################################################################################################